  ######
  #    #
  #$#$ #
  #.@. #
  #    #
  ######
