  ######
###  @ #
# . $$ #
#  .   #
########
